111111111111111111111111111
1T0000TT00C0TT0000TT00C0T01
1011111111111111111111111T1
1T0000000000000000000000101
1011111111111111111111101T1
1010T0000T000T00TT0TTE1C101
1010111111111111111111101T1
1T1000000000000000000000101
1010111111111111111111111T1
1P1000C0000000T000C00000001
111111111111111111111111111