11111111111111111111111
1000010TTT0001C000010P1
101101011101011111T1011
10C100010001000001T1011
11111111T11111110000001
1000001001000T011111101
10111010010001000C1CT01
100T10T0111T11101111101
1T1011111C0T0C10100C101
1T100000111111101T11101
1T111110000000100T10001
10001C11111110111000111
1110101C0000001T00111C1
1E1010111110101T111C101
1000100TTT001C100000001
11111111111111111111111