111111111111111
111111111111111
111C1TTTTT1C111
111T0T0T0T0T111
11111TTCTT11111
111C0T0T0T0C111
111T1TTTTT1T111
111011010110111
111C11E1P11C111
111111111111111
111111111111111