11111111111111111111111111
1CE00000000000000000000001
11000000000000010000000001
10000000000000X1000000001
10000000000000X10000000001
1000000000XX00000000000011
10000000000000000000000001
11111111111111111111111111


