1111111111111111111
100000110000C001C01
10C000TT00000001001
10011100111TTTT11T1
1001E0000P100000001
1TT1111111100001111
100000C00000000T0C1
1111111111111111111