111111111111111111111
1C0T00000P1E00000T0C1
1000T00111111100T0001
10000T011111110T00001
100000T0001000T000001
1000110T00100T011T1T1
10001100111110011C1T1
1T11110000C00001111T1
1T1C11001111100110001
1T1T110T00100T0110001
100000T0001000T000001
10000T011111110T00001
1000T00111111100T0001
1C0T00000C1C00000T0C1
111111111111111111111