1111111111111111111111111111111111
1XXXXXXXXXXXXXXXXXXXXXXXXXXXXXXXX1
10100101001001001010010000000101X1
1010010010101E100010010000000101x1
1XXXXXXXXXXXX1XXXXXXXXXXXXXXXXXXX1
1111111111111111111111111111111111