111111111111111111111111111
100100000001001001100111111
100000000000000000000111111
10000C000E0000C000000111111
100000011111111000000111111
100000000000000000000111111
100000011111100001000111001
100000010000100001000111111
10000001101110C001000111111
100C00000001000000000110111
1000000C000000C100000111111
100100000110001010000000011
110100000011111110000110001
1P0101100000000000000110001
111111111111111111111111111
