111111111111111111111111111
1C0000C10000010000001111111
111TT111000000000000TT000E1
100000110000000000001111111
100000110000010000001C0T0C1
1P0000110000011111111TTTTT1
100000110000000000000000001
111100TT0000000000000000001
1C0T00110001111111111110001
111100110001C00T00T00C10001
1C0100110001C00T00T00C10001
11T100110001111100111110001
11T100110000000000000000001
110000110000000000000000001
111111111111111111111111111