


111111111111111111111111111
100100E00001001001100111111
100000000000000000000111111
100000000000000000000111111
100000000000000000000111111
100000000000000000000111111
100000011111100000000111001
100000010000100000000111111
100000011011100000000111111
100000000000000000000110111
100000000000000100000111111
100100000000000000000000001
100000000000000000000110001
1P00011C0000000000000110001
111111111111111111111111111

