111111111111111111111111111
100100E00001001001100111111
100000000000000000000111111
10000C00000000C000000111111
100000000000000000000111111
100000000000000000000111111
100000011111100000000111001
100000010000100000000111111
10000001101110C000000111111
100C00000000000000000110111
1000000C000000C100000111111
100100000000000000000000011
110100000000000000000110001
1P0101100000000000000110001
111111111111111111111111111
