111111111111111111111111111
1T0100000001001001100111101
1000000000T0000000000111111
10000C000E0000C000000111111
100000011111111000000111111
100000000TTTTT0000000111111
100000011111100001000111001
10000001TTTT100001000111111
100000011T1110C001000111111
100C00000001000000000110111
1000000C000000C100000111111
100100000110001010000000011
110100000011111110000110001
1P0101100000000000000110001
111111111111111111111111111