



1111111111111111111111111111111111
1PPPPPPPPPPP000C00000C000000000001
1P1PP1P1PP100000101001000000010101
1P1PP1PP1P101010001001000000010101
1PPPPPPPPPP0C0000000000000000000C1
1111111111111111111111111111111111




