1111111111111
100100P0000C1
110C010111001
1100110E00001
1111111111111

