


1111111111111111111111111111111111111111
100100E00000000000000C000000011111111111
1000000000000000000000000000011111111111
1000000000000000000000000000011111111111
1000000000000000000000000000011111111111
1000000000000000000000000000011111111111
1000000000000000000000000000011111111111
1000000000000000000000000000011111111111
1000000000000000000000000000011111111111
1000000000000000000000000000011111111111
1000000000000000000000000000011111111111
1000000000000000000000000000011111111111
1000000000000000000000000000011111111111
1000000000000000000000000000011111111111
1000000000000000000000000000011111111111
1000000000000000000000000000011111111111
1000000000000000000000000000011111111111
1000000000000000000000000000011111111111
1000000000000000000000000000011111111111
1000000000000000000000000000011111111111
1P00011C00000000000000000000011111111111
1111111111111111111111111111111111111111

