


111111111111111111111111111111
100100E00001001001100111111111
100000000000000000000111111111
100000000000000000000111111111
100000000000000000000111111111
100000000000000000000111111111
100000011111100000000111111111
100000010000100000000111111111
100000011011100000000111111111
100000000000000000000111111111
100000000000000000000111111111
100000000000000000000111111111
100000000000000000000111111111
100000000000000000000111111111
100000000000000000000111111111
1P00011C0000000000000111111111
111111111111111111111111111111

