




11111111111111111111111111
10000000000000000000000001
10000000000000000000000001
100000000000000E0000000001
10000000000000000000000001
10000C0000P000000000000001
10000000000000000000000001
11111111111111111111111111

