


111111111111111111111111111111
100100E00001001001100111101111
100000000000000000000111101111
100000000000000000000111101111
100000000000000000000111101111
100000000000000000000111101111
100000011111100000000111000111
100000010000100000000111111111
100000011011100000000111111111
100000000000000000000110111111
100000000000000100000111111111
100100000000000000000000000001
100100000000000000000111111101
1000000001100000000000111111101
100000000000000000000110000101
1P00011C0000000000000110000001
111111111111111111111111111111

