


111111111111111111111111111111
100100E00000000000000111111111
100000000000000000000111111111
100000000000000000000111111111
100000000000000000000111111111
100000000000000000000111111111
100000000000000000000111111111
100000000000000000000111111111
100000000000000000000111111111
100000000000000000000111111111
100000000000000000000111111111
100000000000000000000111111111
100000000000000000000111111111
100000000000000000000111111111
100000000000000000000111111111
1P00011C0000000000000111111111
111111111111111111111111111111

