11111111111111111111111111
1CE00000000000000000000001
11000000000000010000000001
10000000000000X1000000001
10000000000000X10000000001
1000000000XX00000000000011
10000000000000000000000001
11111111111111111111111111

 fun(char **arr, int x, int y)

{
    if (arr[x][y] != '1' && arr[x][y] != '.' && arr[x][y])
    {
        arr[x][y] = '.';
        fun (arr,x + 1, y);
        fun (arr,x - 1, y);
        fun (arr,x, y + 1);
        fun (arr,x, y - 1);
    }
}

